{
	"settings": {
		"ground": "G",
		"spawn": {
			"x": 0,
			"y": 0
		}
	},
	"obstacles": [
		[ "*", "*", "*", "*", "*", "*", "*", "*", "*", "*", "*", "*", "*", "*", "*" ],
		[ "*", "T", "T", "T", "T", "R", "T", "T", "*", "T", "T", "T", "T", "T", "*" ],
                [ "*", "*", "*", "*", "H", "R", "*", "*", "*", "T", "*", "*", "*", "*", "*" ],
                [ "A", "T", "T", "*", "R", "R", "*", "R", "T", "T", "*", "T", "T", "T", "T" ],
                [ "*", "*", "*", "*", "R", "*", "*", "R", "*", "T", "*", "*", "*", "*", "*" ],
                [ "*", "R", "R", "R", "R", "B", "*", "R", "*", "T", "T", "T", "T", "T", "F" ],
                [ "*", "R", "*", "*", "*", "*", "*", "R", "*", "*", "*", "*", "*", "*", "*" ],
                [ "*", "R", "*", "T", "T", "T", "*", "R", "T", "T", "T", "T", "T", "T", "T" ],
                [ "*", "*", "*", "T", "*", "*", "*", "*", "*", "*", "*", "*", "*", "*", "*" ]
	]
}