{
	"settings": {
		"ground": "G",
		"spawn": {
			"x": 1,
			"y": 1
		}
	},
	"obstacles": [
		[ "*", "*", "*", "*", "*", "*", "*", "*", "*", "*" ],
		[ "*", "*", "*", "*", "*", "*", "*", "*", "*", "*" ],
		[ "*", "*", "*", "*", "*", "*", "*", "*", "*", "*" ],
		[ "*", "W", "W", "W", "W", "*", "*", "*", "*", "*" ],
		[ "*", "W", "*", "*", "*", "*", "*", "*", "*", "*" ],
		[ "*", "W", "*", "W", "W", "*", "*", "*", "*", "*" ],
		[ "*", "W", "*", "W", "*", "*", "*", "*", "*", "*" ],
		[ "*", "*", "*", "*", "*", "*", "*", "*", "*", "*" ],
		[ "*", "*", "*", "*", "*", "*", "*", "*", "*", "*" ],
		[ "*", "*", "*", "*", "*", "*", "*", "*", "*", "*" ],
		[ "*", "*", "*", "*", "*", "*", "*", "*", "F", "*" ],
		[ "*", "*", "*", "*", "*", "*", "*", "*", "*", "*" ],
		[ "*", "*", "*", "*", "*", "*", "*", "*", "*", "*" ]
	]
}