{
    "settings": {
        "ground": "G",
        "spawn": {
            "x": 12,
            "y": 5
        }
    },
    "obstacles": [
        [ "*", "R", "*", "*", "*", "R", "A", "*", "*", "R", "T", "*", "*" ],
        [ "T", "R", "*", "R", "*", "R", "T", "R", "*", "R", "*", "*", "*" ],
        [ "*", "R", "*", "R", "*", "R", "*", "R", "*", "R", "R", "R", "T" ],
        [ "*", "R", "*", "R", "*", "R", "*", "R", "*", "*", "*", "R", "T" ],
        [ "*", "R", "*", "R", "R", "R", "*", "R", "R", "R", "*", "R", "R" ],
        [ "T", "R", "*", "T", "H", "*", "*", "*", "*", "*", "*", "*", "*" ],
        [ "R", "R", "R", "R", "R", "R", "R", "R", "*", "R", "R", "R", "R" ],
        [ "F", "*", "*", "R", "*", "*", "*", "*", "*", "R", "*", "*", "T" ],
        [ "R", "R", "*", "R", "*", "R", "R", "R", "*", "R", "*", "T", "*" ],
        [ "*", "*", "*", "R", "*", "*", "*", "R", "*", "R", "*", "*", "T" ],
        [ "T", "*", "*", "R", "*", "*", "T", "R", "*", "R", "T", "*", "T" ],
        [ "T", "*", "*", "R", "T", "*", "*", "R", "*", "R", "R", "*", "*" ],
        [ "*", "*", "*", "R", "*", "*", "*", "R", "*", "B", "R", "T", "*" ],
        [ "*", "*", "*", "*", "*", "T", "*", "R", "*", "*", "R", "*", "*" ]
    ]
}