{
    "settings": {
        "ground": "G",
        "spawn": {
            "x": 0,
            "y": 3
        }
    },
    "obstacles": [
        [ "*", "*", "*", "*", "*", "*", "W", "W", "*", "*" ],
        [ "*", "W", "W", "W", "*", "*", "*", "*", "F", "*" ],
        [ "*", "*", "*", "W", "*", "W", "*", "W", "*", "*" ],
        [ "*", "H", "*", "W", "W", "W", "W", "*", "*", "W" ],
        [ "*", "*", "W", "*", "*", "W", "*", "W", "*", "W" ],
        [ "*", "*", "*", "*", "*", "*", "*", "*", "*", "W" ],
        [ "*", "*", "W", "W", "W", "*", "*", "*", "*", "*" ],
        [ "W", "W", "W", "*", "W", "*", "*", "*", "*", "*" ],
        [ "*", "W", "W", "*", "*", "*", "*", "*", "W", "*" ],
        [ "B", "*", "*", "*", "W", "*", "*", "*", "*", "*" ]
    ]
}